#####################################################################################################
S #               #         #             #             # #     #         #   #       #   #         #
# ####### ##### # ##### ##### ######### ### ### ####### # # # ### # ##### # # # ### # # # # ##### # #
# #     # #     # #     #     #       #   #   # #   # # # # #     # #       # # # # # # # #   # # # #
# # ### ### ##### # ##### ##### ##### # # ### # # # # # # # ####### ####### ### # # # ### ### # # ###
#   #   #   # #   # #     #   # #     # #   # #   # # # # #   # #   #   #   #     # # #   #   # #   #
##### ### ### # ### # ##### # # ##### ### ### ##### # # # ### # # ### # ##### ##### # # ### ### ### #
# #   #   # #   #   # #     # #     #     #   #   # #   # #   # #   # # #     # #   #   #   #   #   #
# # ##### # # ### # # ### ### ##### ##### # ##### # # ### # ### ### # # # ##### # ### ### ### # # ###
# #     # #   #   # #     # # #   # #   # #       # #   #   #     #   # # #     # #   #   # # # #   #
# ##### # # ##### ######### # # ### # ### # ####### ### ### # # ####### # # # ### ##### ### # # ### #
#     #   # #   #           # # #   #     # #       # #   #   # #       #   # #   #   #   #   #   # #
# ### ##### # # ##### ### ### # # ### ##### # ####### ### ##### # ########### # ### # ### ####### # #
#   #     #   # #   #   # #   # # #   #     # #       #   # #   #   #       # # #   #   #   #     # #
### # ######### # # ### ### ### # ##### ##### # ##### # ### # ##### # # ##### # # ##### ### # ##### #
# # #         #   #   #   #   # #     # #     # #   #   #     #   #   #       #   # #     # # #     #
# # ##### ### ####### # # ### # ##### # # ##### # ####### ##### # ################# # ##### # # ### #
# #     # # #   #     # #   #     #   # # # #   #       #       #     #   #         # #       #   # #
# # ##### # ### # ##### # # # ##### ### # # # ### ##### ############# # # # ##### ### # ######### # #
#   #     #     #   #   # # # #     #   # #   #   #   # #     #       # # #   # # #   #   #       # #
##### ############# # ### # # # # ### ### # ####### # # # ### # ######### ### # # # # ### # ####### #
#     #   #       # #   # # # # # #   #   #     #   # #     #         #     #   # # # #   #     #   #
# ##### # # ### ### ### # ### # # # ### ####### # ### ##### ######### # ##### ### # ### ####### #####
#       #   # #     # # #     # # #   # #     # #   # #   #   # #   # #       #   # #   #     #     #
# ########### ####### # ####### # ### # # ### # ### # # # ### # # # # ### ##### # # # ### ##### ### #
# #         #       #   #   #   # #   # # #   #     #   #   #   # # #   # #     # #   #   #   # #   #
# ####### # # ##### # ### ### ##### ### ### ############### ##### # ### # # ########### ### # ### # #
#       # #   #   # #   #   #       # #   # #     #       #       # # # # #     #       #   #     # #
####### # ####### # ### ### ######### ### # # # ### ##### ######### # # # ##### # ##### # ######### #
#   #   #   #     #   #   #             # #   #   # #   #   #       #   #   # #   # #   # #     #   #
# # # ##### ### ##### ### # ######### ### # ##### # # # ### # ####### ##### # ##### # # # # ### # ###
# #   #   #   #     # #   #   #   #   #   # #     # # #   #   #     # #   #   #     # # #     # #   #
# ####### ### ##### # # ##### # # # # # ### # ### # ### # ##### # ### ### ### # ##### # ####### ### #
#       #           #   #     # #   # # #   # #   #   # #       # #   #   #     #   # #   #     #   #
####### # ######### ########### ####### ##### # ##### # ######### # ### ### ##### # # ##### ##### ###
#       # #     #   #           #       #     # #   # # #     #   #   #     #     #   #     #   #   #
# ####### # ### # ### ########### ####### ##### # ### # ##### # ##### ### ### ####### # ####### ### #
# #     # # #   # #   #           #       #     # #   #       #     #   #   # #       #   #     #   #
# ### # ### # ### # ### ########### # ##### ##### # ######### ### ##### ##### # ######### ### ### ###
#     #     #   #   #   #     #   # #   #   #     # #   #       #     # #     #     #   # #   #   # #
############### ##### ### # # # # # ### ### # ### # # # # ######### ### # ########### # # # # # ### #
#   #     #   #   #   #   # # # #     #   #   # # #   # #   # #   # #     #           #   # # # #   #
# ### # # ### ### # ### ### # # ######### ##### # ##### ### # # # # # ##### ############### ### # # #
#     # #     # # #   # # # # # #         # #     #   # #     # #   #   #   #       #     #     # # #
# ##### ##### # # ### # # # ### # ######### # ##### # # ##### # ####### # ######### # ### # ##### # #
#   #   #   #   #     # # #     # #         #     # # #   #   #       # #         #     # # #     # #
##### ##### ### ####### # ####### ##### ### ##### # ##### # ######### # ######### ##### # # # ##### #
#   # #     #   #     #   #     # #     # #     #   #   # #     #   # # #       #     # # #   # #   #
# # # ### ### ### ### ### # ##### # ##### ### ##### # # # ##### ### # # # ##### ##### ### ##### # ###
# # #   #     #   # #   # #   #   #     #     #     # #   #   # #   #   # #   # #   #   #     #   # #
# # ### # ##### ### # ### # # # # ##### ### ### ##### ##### # # # # ##### # ### # # ### ### # # ### #
# #     #     #     #   # # # # # #   #   # #   # #   #     # #   # # #   # #   # #     #   # # #   #
# ########### ##### ### # ### # ### # ### # # ### # ### ##### ##### # # ### # ### ####### ##### # # #
#   # #     #     # # # #   # # #   #   # # #     #   # #   #   #   # # #     #   #   #     #   # # #
### # # # ### ##### # # ### # # # ##### # ### ####### # # # # # # ### # ### ### # # # # ### # ### ###
#   #   #   # #   # # #     # #   #   # #     #   #   # # # # #   #   #   #   # #   # # #   #   #   #
# ##### ### # # # # # ####### ####### # ####### # # ### # # ### ### # ### ### ####### # # # ### # # #
# #   # # #   # #   #   #       #     # #     # #   #   # #   #   # #   #   #       # # # # #   # # #
# # # # # ##### ##### # ### # # # # ### # ### # ##### ### ### ### ### # ### ####### # # # ### ##### #
# # # #     #   #     #   # # # # # #   #   # # #       # #   #   #   # # # #       # # #     #   # #
# # # # ##### ### # ##### ### # ### # ##### # # ######### # ##### # ### # # ### ##### # ####### # # #
# # # # #   # #   # #   #     #     #     # # #     #   # # #   #   #     #   #       # #       #   #
# # # ### # # # ### # # ########### ##### # # ##### # # # # # # ######### ### ######### # ### ##### #
#   #   # #   # #   # # #   #       #     # #     #   #   # # #         #   # #   # #   #   # #     #
# ##### # ####### ### # # # # ####### ##### ##### ######### # ######### ### # # # # # ####### ##### #
# # #   # #       #   # # # # #     # #     #   #   #     # #     # #   # # #   # #           #   # #
# # # ### # ########### # # # # ### # # ##### # ### # ### # ### # # # ### # ##### ############# # ###
#   #   #   #   #       # # #   # # #     #   #     #   # #   # # # # #     #   #         #     #   #
# ##### ##### # # ##### # # ##### # ####### ########### # ### ### # # ### ### # ##### ### # ####### #
# #   #       # # #   # # #         #       #   #       #   #     # #   #   # #     #   # #   #     #
# # # ### ##### # # ### # ########### ##### # # # ####### ######### ### ##### ##### ### # # ### #####
# # #     #   #   # #   #     # #     #     # #   #     #     #       #     # #     #   #   #   #   #
# # ####### # ##### # ####### # # ######### # ####### # ##### # ##### ##### # # ##### ####### # # # #
# # # #     #       #   #   #   # #   #   # #         #   #   #     #     #   # #         #   # # # #
### # # ##### ##### # ### # ### # # # # # # ############# # # ##### ### ####### # ####### # # ### # #
#   # # #   # #   #   #   #     #   # # # # #   #       # # #   # #   #   #     # #   #   # # #   # #
# ### # # # # # # ##### ############# # # # # # # ##### # # ### # ### ### # ####### # # ### ### ### #
#   #   # # #   # #                 # # # #   # #     # # #   # # #   # #   # #     # #   #       # #
# # # ### # ##### # ####### ##### ### # # ##### ##### # # ### # # # ### ##### # # ### ### ####### # #
# # #   # # #     # #     # #   # #   # #   # #   # # # # #   #   # #     #     #   #   # #     # # #
# # # ### # # ##### # ### ### # ### ### ### # ### # # # # # ####### # ##### ####### ### ### ### ### #
# # # #   # # #     # # #     #     #   # # # #     # #   #   #     #   #   #   # #   #     # #   # #
### # # ### ### ##### # ##### ####### ### # # # ##### ####### # ##### # # ### # # ### ####### ### # #
#   # #   #   #   #   #   #   #     # #   # #   #   #   #   #   #   # #   #   #     #   #         # #
# ### ### ### ### # ### # # ### ### # # # # # ### # ### ### ##### # # ####### ##### ### # ######### #
# #   #   # #   # #   # # #   # # # #   # # # #   # #   #     #   # #         #   # #   # #       # #
# ##### ### # ### ### # # ### # # # ### ### ### ### # ### ### # ### ############# # # ### # ##### # #
# #     #   #     # # # #     #   #     #   #   # #   #   # #   # # #   #   #     # # # #   #   #   #
# # ##### ######### # ##### ##### ####### ### ### ##### # # ##### # # # # # # ##### # # ##### # ### #
#   #   #           #     # #   #   #   # #   #   # #   # # #     #   # # # #       # #       #   # #
# ### # # ### ##### ##### # ### ### ### # # ### # # # ### # # ### ##### # # # ####### # ######### # #
#   # # # # #     #   #   #   #   #   # #   #   # #     # #   # #     #   # # #       #   #   # #   #
### # ### # ##### # ### ##### # # ### # ####### # # ##### # ### # ######### ### ######### # # # #####
# # #       #     # #   #   #   # # #   #       # # #   # # #   #         #     #   #   #   #       #
# # ####### # ##### # ### ####### # ### ### ##### ### # # # # ########### ######### # # ########### #
# #       # #   # # #   #         #   #   #   #   #   #   # #         # # #         # #   #   #   # #
# ####### ##### # # ### ######### ### ### # # # ### ####### # # ##### # # # ##### ### # # # ### # # #
# #     #       # #   #         #     #   # # #   # #   #   # #     # # #   # #   #   # #   #   # # #
# # # ########### ### ######### ####### ##### ### # # ### ######### # # ##### # ### ### ##### ### # #
#   #                         #               #     #               #         #       #         #   E
#####################################################################################################