#####################
S #   #         #   #
# # # # ##### # # # #
#   # # #   # # # # #
##### # # ### # # # #
#   # #   #   #   # #
# ### # ### ####### #
#     # #   #     # #
# ####### ### # ### #
#         #   #     E
#####################