#########################################################
S #       #   #     #     #         #           #       #
# ### ### # # ### ### ### # # # ##### ### ##### ####### #
#   # #     #   # #     # # # # #     # #   # #         #
### # ######### # # ##### # # # # ##### ### # ######### #
# # #     #     #   #     # # # #   #     # #         # #
# # ### # # ##### ### ##### # # ### ### ### # ### ### # #
# #   # # #   # #   #   #   # # # #   #   # # #   # # # #
# ### ### ### # # ##### # ### # # ### ### # ### ### # # #
#   #   # #   #   #   #   #   #     # #   #   # #     # #
# # ### # # ##### # # # ### ##### ### # ##### # # ##### #
# #   #   # #   # # # # #   #   # #   # #     # # #   # #
##### ##### # # ### # # # ### # ### ### # ##### ### # # #
#       #   # #   # # # #     #         # #     #   #   #
# ####### ### ### # # ################### # ### # #######
#             #     #                     #   #         E
#########################################################