###############################################################################################
S       #         #             #       #     #           #         # #       #     #         #
####### ##### ### ### # # ####### ##### # # # # ##### ##### ##### # # # ### # ### # ####### # #
#     # #     # #   # # # #         # #   # # #     #         #   # #   #   #     # #       # #
##### # # ##### ### # # ### ####### # ##### ##### ##### ####### ### ##### # ####### # ####### #
#     #   #       # # #     #     #       #   #   #   # #       # #     # # #   #   # #     # #
# ######### ##### # ### ##### ### ####### ### # ### # ### ####### ##### # ### # # ### # # ### #
#   #   #   #   # #   # #   #   # #     #   #   #   #     # #       # # #   # # #     # #     #
# # # # # ### # # ### # # # ### # ### ##### ##### ######### # # ### # # # # # # ####### #######
# #   # #     # # #   # # #     #   #     #   #   #       #   #   #   # # #   #       # #     #
# ##### ####### # # ##### ######### ### # ### # ### ### # # ##### ### # ############# # # ### #
# # #   #   #   #   #   #   #     #   # #     # # #   # # #   #   # # #     #         #   # # #
# # # # # ### ####### # # # # ### ### # ####### # ### # # ### # ### # ##### # ############# # #
#   # #   #   #       # # # # #     # # # #     # #   # # #   #   #   #   #   # #   #       # #
### # ### # ### ####### ### ### ##### # # # ##### # ### ### ##### # ### # ##### # # # ##### # #
#   # #   #   #   #   #     #   #   # #   # #     #   # #   #     #   # # #   #   # # #     # #
# ### # ##### # # # ######### # # # # ### # # # ##### # # ### ####### # ### # # ### # # ##### #
#   # # #     # # #   #       # # #   #   # # #   #   # #   #   #       #   #   #   # #   #   #
### # # # ####### ### # ### ##### ######### ##### # ### ### ### # ####### ####### ### ### # ###
# # # # #   #   # #   # #   #   #     #   # #     # #   #   # # #   #   # #   # #   #   #   # #
# # # ##### # # # # ### # ### # ##### # # # # ##### # ### ### # ##### # # # # # ### ### ##### #
#   #         #   #     #     #         #   #       #         #       #     #     #           E
###############################################################################################