###################################################################################################
S #   #     #       #         # #           #     #       #         #       #   #     #     #     #
# # # ### # ### # # ##### ### # # # ####### ### # # ##### ##### ### ### ### # # # # # # # # # ### #
#   #     #   # # #       # # #   # #     #   # # # #           # #   # # # # #   # # # # # # #   #
############# # # ######### # ##### # # ##### # # # # ########### ### # # # ##### # # # # # # # # #
#     #       # #   #     # #       # #     #   # # # #   #   # #     # #       # # # # # # # # # #
# ### # ####### ### # # # # ######### ### ####### # ### # # # # # ##### ####### # # # ### ### # # #
#   # #   #       # # # #   #     #   # #   #     #     #   # #       # #     # # # #     #   # # #
##### ### ######### # # ### ### # # ### ### # ##### ######### # ##### # # ### # ### ##### # ### ###
#       #       #   # # # #     # #       #   #           #   # #   #   #   # #     #   # #   #   #
# ##### ####### # ##### # ####### ####### ################# ### # # # ### ### ### ##### # ### ### #
# #   # #   # # # #     # #   #   #     #   #   #         # #   # # # #   #   #   #   #   #     # #
# # # # # # # # # # ##### # # # ### ### ### # # # ####### # # ### # # # ### ### ### # ##### ##### #
#   # # # # # #   # #   #   # # #   #   # #   #   #       # # #   # # #   # #   #   #       # #   #
# ### # # # # ##### # ### ### # # ### ### ######### ####### ### ### ##### # ##### ########### # ###
# #   #   #   #     #   #   # #   #           #   # #   #   #   # #     # #     #   #         #   #
# # ### ##### # # ##### ### # ##### ######### # # # # # # # # ### ##### # ##### ### # # ######### #
# # #   #   # # # #       # #   #   #   #   #   # #   # # #   #       # #   # #     # # #   #     #
# # ##### # # ### # ####### ### # ### # ### ##### ##### # ##### ### ### ### # ####### ### # # ### #
# #   #   # #     # #         #     # # #   #     #   # # #     #   #     #   #     # #   #   #   #
##### # ### ####### # ############### # # ### ##### # # # # ##### ### ### ### # ### # # ####### ###
#     #   #     # #   #     #         # # #   #   # #   #   #       #   # #   #   #   # #         #
# ####### ##### # # ##### # # ######### # # ### # # ############# ##### ### ##### # ### ###########
#   #   #   #   # #       # #   #       # # # # #   #           # #     #   #     # #   #         #
# # # # ### # ### ######### ### # ####### # # # ##### ######### ### ##### ### ##### # ### ####### #
# # # #   # # #             #   # #         # # #   # #     #   #   #   #     #     #       #     #
# # # ### # # ####### ####### ### ######### # # # # # # # ### ### ### # ####### ############# ### #
# #   # #   # #     #   #   # #   #   #   #   #   #   # #     #       # #       #   #   # #   #   #
# ##### ##### # ### # ### # # # ### # # # ### ######### ####### ####### # ####### # # # # # #######
#     #     #     # # #   #   #   # #   #   # #       # # #   # #       # #   #   # # # # #       #
##### ##### ####### ### ######### # ####### ### ##### # # # # # # ##### # # # ### # # # # ####### #
# #   #     #       #   #     # #   #   #   #   #   #   # # # # #   #   #   #     # # # #       # #
# # ### ##### ##### # ### ### # ##### ### ### ### ####### # # # ### # ############# # # # ### # # #
# #     #     #   # #     # #   #   #   # #   #             #   #   #     #         # # #   # # # #
# ##### # ### # # ######### ### # # # # # # ############### ##### ####### # ######### # ### # ### #
#   # # # #   # # #     #     # # #   # # #       #       #   #   #   #   #   # #     #   # # #   #
# # # # # ##### # # # ### # ### ##### # # ####### # ##### ##### ##### # ##### # # # ##### ### # # #
# #   # #   #   # # #   # #   #     # # #       # # #   #   #   #   # #   #   #   # #   #     # # #
# ### # ### # ### # ### # ### ##### # # # ##### # # # # ### # ### # # ### # ### ### # # ### ### # #
#   # # #   # # # #   #   # # #     # # #     # #   # # #   #   # # #     #   # #   # # #   #   # #
# # ### # ### # # ### ##### # # ####### ##### ####### # # ##### # # # ####### ### ### # # ### ### #
# #   # #   #   #   # #     # #       #     #     #   #   #     # # # #     #     # # #   #   # # #
# ### # ### ### ### # # # ### ####### ##### ### # # ####### # ### # ### ### # ##### # ##### ### # #
#   #   # #       # #   # #   #     #     #   # # #       # #   # # #     #   #   # #   #   # #   #
### ##### ######### ##### # # # ### ##### ### # ######### ### # # # # ######### # # # ### ### # ###
#   #           #     #   # # #   #     #     #     #   #   # #   #     #       # #   #   #     # #
# ########### # # # ### ### ### ### ### ##### ##### # # ### # ########### ####### # ### ### ##### #
# #           # # # #   # # #   #   #   #     #     # # #   # #   #       #       #   # # # #     #
# # ########### # ### ### # # ### ####### ##### ##### # # ### # ### ####### ########### # # # ### #
#   #       #   #     #   #     # #     #   #   #     # #   #   #   #     #             #   # #   #
##### ### ### ########### ####### # ### ### # ### ##### ### ### # ##### # ############### ### # ###
# #   # #     #           # #     # # #   # #   # #   #   #   # # #   # #       #   #   # #   #   #
# # ### ####### ######### # # ### # # # ### ### # # # # ##### # # # # ####### # # # # # # ####### #
#   # #         #       #   # #   #   #   #   #   # # #   #   # # # #   #     #   # # # #   #     #
# ### # # ####### ##### ### # ####### ### ### ##### ##### # ### # # ### # ####### ### # ### # ### #
#   #   #   #   #   # # #   # #   #   # #   #     # #   #   # # #   # # #   # #   #   # #   #   # #
### ####### # # ### # # # ### # # # ### # ####### # # # ##### # ##### # ### # # ### ### # ### # ###
# #         # #   #   # # #   # #   #   # #     # # # #     #   #     #   # #   #   #   #   # #   #
# ########### ### ### # # # ### ####### # # # ### # # ##### # ### # ##### # # ### ### ##### ##### #
# #         # #   #   # # #     #       # # # #   #   #   #   #   # #     # # #   # #     #       #
# # ##### ### # ### ### # ####### # ### # # # # ### ### # ##### ### # ##### # # ### ### ######### #
# #   #   #   #   # # #   #       # # # #   #   #   # # #       #   # #     # # #     #   #   #   #
# ### # ### ##### # # ############# # # ######### ### # # ####### ### # ### # # # ### ### # # # ###
# #   # #     #   #   #             # # #         #   # #       # #   # # # # #   #   # #   #     #
# # ### # ##### # ### ### ########### # ####### ### # # ####### # # ### # # # ##### ### ######### #
# #   #   # #   #   #     #       #   #       # # # #   #       # #   #   # #   #   #   #     #   #
# ### ##### # ############# # ### # ######### # # # ##### ### ####### ##### ##### ### ### ### # ###
#   # #   # #   #       #   # #     #   #     # #   #     #   #     # #   # #   # #     # # # #   #
# ### # # # ### # # ### # ### ##### # # # ##### ##### ### ##### ### # # # # # # # ### # # # # ### #
#       #   #   # #   # # #   #   # # #   #   #       # # #     #   # # # #   # #   # # #   # #   #
######### ### ### ### ### # ### # ### ##### # ######### # # ##### ### # # ### # ### ### ### # #####
#   #   # #   #   # #     #     #     #   # #       #     # #   #   # # #   # #   #     #   #     #
# # # # ### # # ### ################### # # ##### ### ##### # # ### # # ### ### ##### ### ####### #
# #   #     # # #         #         #   # # #   # #   #   # # #     #   # #   #       #   #     # #
# ########### # # ### ##### ##### ### # ### # # # # ### # # # ####### ### ### # ####### ##### # # #
#       #     # #   # #   #     #     # #   # # # #   # # # #   #     #   #   #       #       # # #
####### ####### ### # # # ##### ####### # ### # # # ### # # ### ##### # ### ####### ######### ### #
#       #     # # # #   #     #   # #   #   # # #   #   #   # #     #   #   #       #         #   #
# # ##### ### # # # ######### ### # # # ### ### ##### ####### ##### ### # ########### ######### # #
# # #   #   #   #   #       #   #   # #   # #     #   #       #     #   #   #     #   # #   #   # #
# ### # ### ##### ######### # ##### # ##### # # ### ### ##### # ##### ##### # ### # ### # # # ### #
#     #   #     #   #       # #   # #         # #   #   #   # #     #     #     # #     # #   #   #
# ##### ####### ### # ####### # # # ############# ### ### # ####### ### ####### # ##### # ##### ###
# # #   #     #   #   #     #   # #   #           # #     #       # # # #   #   #       # #   #   #
# # # ### ### ### ### # ### # ### ### # ########### # ######### ### # # # # ### ######### ### ### #
#   #   #   #   # #   #   # # #   #   # # #     #   #         #     #   # #   #     #     #   #   #
### ### ### ### # # ##### # # # ### ### # # ### # # ######### ########### ### ####### ##### # # ###
# #   #     #   # # #   # # # # #   #   #   # #   #     #   #   #         #   #     # #     # #   #
# ### ####### ### ### # # # ### # ### ### ### ####### # # # ### # # ####### ### ### # # ##### ### #
#   #   #   #   #     #   # #   # #   #   #       #   #   #   # # # #     #     # #   #   # # #   #
# # ### # # ### ########### # ### # ### ### # ### # ####### ### # # # # ######### ##### # # # # ###
# #   #   # # #   #       # #   # # #   # # #   # # #     # #   # # # #           #     # #   # # #
# ### ##### # # ### ##### # ### # # # ### # ### # # # ##### # ##### # ##### # ##### ##### # ### # #
# #     #   # #     #     #   #   # # #       # # # #       #       # #     # #     #     # #   # #
# # # ### ### ####### ####### ##### # ####### # ### ##### ########### # ####### ##### ####### ### #
# # # #   #       #   #       #     # #     # # #   #   # #     #   # #     #   #   #   #   # #   #
# # ### ######### # ### ####### ##### # ### ### # ### # ### ### # # # ##### # ##### ### # # # # # #
# #               #             #       #       #     #       #   #       #           #   #     # E
###################################################################################################